11 11 11 11 11 11 11 11 11 11 11 11 11 11 11 11 11 11 11 11 11 11 11 11 11 11 11
11 13 13 13 13 13 13 13 13 13 13 19 19 19 19 19 11 11 11 11 11 11 11 11 11 11 11
11 13 13 13 13 13 13 13 13 13 13 19 19 19 19 19 11 11 11 11 11 11 11 11 11 11 11
11 13 13 13 13 13 13 13 13 13 13 19 19 19 19 19 11 11 11 11 11 11 11 11 11 11 11
11 13 13 13 13 13 13 13 13 13 13 19 19 19 19 19 11 11 11 24 24 24 24 24 11 11 11
11 13 13 13 13 13 13 13 13 13 13 19 19 19 19 19 11 11 11 24 24 24 24 24 11 11 11
11 13 13 13 13 13 13 13 13 13 13 19 19 19 19 19 11 11 11 24 24 24 24 24 11 11 11
11 10 10 10 10 10 10 10 10 10 10 19 19 19 19 19 11 11 11 24 24 24 24 24 11 11 11
11 10 10 10 10 10 10 10 10 10 10 19 19 19 19 19 11 11 11 24 24 24 24 24 11 11 11
11 10 10 10 10 10 10 10 10 10 10 19 19 19 19 19 11 11 11 11 11 11 11 11 11 11 11
11 10 10 10 10 10 10 10 10 10 10 19 19 19 19 19 11 11 11 11 11 11 11 11 11 11 11
11 10 10 10 10 10 10 10 10 10 10 19 19 19 19 19 11 11 11 11 11 11 11 11 11 11 11
11 10 10 10 10 10 10 10 10 10 10 19 19 19 19 19 11 11 11 11 11 11 11 11 11 11 11
11 13 13 13 13 13 13 13 13 13 13 12 12 12 12 12 12 12 12 12 12 12 12 12 12 12 11
11 13 13 13 13 13 13 13 13 13 13 12 12 12 12 12 12 12 12 12 12 12 12 12 12 12 11
11 13 13 13 13 13 13 13 13 13 13 12 12 12 12 12 12 12 12 12 12 12 12 12 12 12 11
11 13 13 13 13 13 13 13 13 13 13 12 12 12 12 12 12 12 12 12 12 12 12 12 12 12 11
11 13 13 13 13 13 13 13 13 13 13 12 12 12 12 12 12 12 12 12 12 12 12 12 12 12 11
11 13 13 13 13 13 13 13 13 13 13 12 12 12 12 12 12 12 12 12 12 12 12 12 12 12 11
11 26 26 26 26 26 10 10 26 26 26 26 26 26 26 26 26 26 26 12 12 26 26 26 26 26 11
11 10 10 10 10 10 10 10 10 10 10 12 12 12 12 12 12 12 12 12 12 12 12 12 12 12 11
11 10 10 10 10 10 10 10 10 10 10 12 12 12 12 12 12 12 12 12 12 12 12 12 12 12 11
11 10 10 10 10 10 10 10 10 10 10 12 12 12 12 12 12 12 12 12 12 12 12 12 12 12 11
11 10 10 10 10 10 10 10 10 10 10 12 12 12 12 12 12 12 12 12 12 12 12 12 12 12 11
11 10 10 10 10 10 10 10 10 10 10 12 12 12 12 12 12 12 12 12 12 12 12 12 12 12 11
11 10 10 10 10 10 10 10 10 10 10 12 12 12 12 12 12 12 12 12 12 12 12 12 12 12 11
11 11 11 11 11 11 11 11 11 11 11 11 11 11 11 11 11 11 11 11 11 11 11 11 11 11 11
