11 11 11 11 11 11 11 11 11 11 11 11 11 11 11 11 11 11 11 11 11 11 11 11 11 11 11 11 11 11 11 11 11 11 11 11 11 11 11 11
11  13 13 13 13 13 13 13 13 13 13 11 13 13 13 13 13 13 13 13 13 13 13 13 13 13 13 13 13 13 13 11 10 10 10 10 10 10 10 11
11  13 13 13 13 13 13 13 13 13 13 11 13 13 13 13 13 13 13 13 13 13 13 13 13 13 13 13 13 13 13 11 10 10 10 10 10 10 10 11
11  13 13 13 13 13 13 13 13 13 13 11 13 13 13 13 13 13 13 13 13 13 13 13 13 13 13 13 13 13 13 11 10 10 10 10 10 10 10 11
11  13 13 13 13 13 13 13 13 13 13 11 13 13 13 13 13 13 13 13 13 13 13 13 13 13 13 13 13 13 13 11 10 10 10 10 10 10 10 11 
11  13 13 13 13 13 13 13 13 13 13 11 13 13 13 13 13 13 13 13 13 13 13 13 13 13 13 13 13 13 13 11 10 10 10 10 10 10 10 11 
11  13 13 13 13 13 13 13 13 13 13 11 13 13 13 13 13 13 13 13 13 13 13 13 13 13 13 13 13 13 13 11 10 10 10 10 10 10 10 11 
11  13 13 13 13 13 13 13 13 13 13 11 13 13 13 13 13 13 13 13 13 13 13 13 13 13 13 13 13 13 13 11 10 10 10 10 10 10 10 11 
11  13 13 13 13 13 13 13 13 13 13 11 13 13 13 13 13 13 13 13 13 13 13 13 13 13 13 13 13 13 13 11 10 10 10 10 10 10 10 11 
11  13 13 13 13 13 13 13 13 13 13 11 13 13 13 13 13 13 13 13 13 13 13 13 13 13 13 13 13 13 13 11 10 10 10 10 10 10 10 11 
11  13 13 13 13 13 13 13 13 13 13 11 13 13 13 13 13 13 13 13 13 13 13 13 13 13 13 13 13 13 13 11 10 10 10 10 10 10 10 11 
11  13 13 13 13 13 13 13 13 13 13 11 13 13 13 13 13 13 13 13 13 13 13 13 13 13 13 13 13 13 13 11 10 10 10 10 10 10 10 11 
11  13 13 13 13 13 13 13 13 13 13 11 13 13 13 13 13 13 13 13 13 13 13 13 13 13 13 13 13 13 13 11 10 10 10 10 10 10 10 11
11  10 10 10 10 10 10 10 10 10 10 11 11 11 11 11 11 11 11 11 11 11 11 11 11 11 11 11 11 11 11 11 11 11 11 11 11 11 11 11
11  10 10 10 10 10 10 10 10 10 10 11 10 10 10 10 10 10 10 10 10 10 10 10 10 10 10 10 10 10 10 10 10 10 10 10 10 10 10 11
11  10 10 10 10 10 10 10 10 10 10 11 10 10 10 10 10 10 10 10 10 10 10 10 10 10 10 10 10 10 10 10 10 10 10 10 10 10 10 11
11  10 10 10 10 10 10 10 10 10 10 11 10 10 10 10 10 10 10 10 10 10 10 10 10 10 10 10 10 10 10 10 10 10 10 10 10 10 10 11
11  10 10 10 10 10 10 10 10 10 10 11 10 10 10 10 10 10 10 10 10 10 10 10 10 10 10 10 10 10 10 10 10 10 10 10 10 10 10 11
11  10 10 10 10 10 10 10 10 10 10 11 10 10 10 10 10 10 10 10 10 10 10 10 10 10 10 10 10 10 10 10 10 10 10 10 10 10 10 11
11  10 10 10 10 10 10 10 10 10 10 11 10 10 10 10 10 10 10 10 10 10 10 10 10 10 10 10 10 10 10 10 10 10 10 10 10 10 10 11 
11  10 10 10 10 10 10 10 10 10 10 11 10 10 10 10 10 10 10 10 10 10 10 10 10 10 10 10 10 10 10 10 10 10 10 10 10 10 10 11
11  10 10 10 10 10 10 10 10 10 10 11 10 10 10 10 10 10 10 10 10 10 10 10 10 10 10 10 10 10 10 10 10 10 10 10 10 10 10 11 
11  10 10 10 10 10 10 10 10 10 10 11 10 10 10 10 10 10 10 10 10 10 10 10 10 10 10 10 10 10 10 10 10 10 10 10 10 10 10 11 
11  10 10 10 10 10 10 10 10 10 10 11 10 10 10 10 10 10 10 10 10 10 10 10 10 10 10 10 10 10 10 10 10 10 10 10 10 10 10 11 
11  10 10 10 10 10 10 10 10 10 10 11 10 10 10 10 10 10 10 10 10 10 10 10 10 10 10 10 10 10 10 10 10 10 10 10 10 10 10 11
11  10 10 10 10 10 10 10 10 10 10 11 10 10 10 10 10 10 10 10 10 10 10 10 10 10 10 10 10 10 10 10 10 10 10 10 10 10 10 11 
11  10 10 10 10 10 10 10 10 10 10 11 10 10 10 10 10 10 10 10 10 10 10 10 10 10 10 10 10 10 10 10 10 10 10 10 10 10 10 11 
11  10 10 10 10 10 10 10 10 10 10 11 10 10 10 10 10 10 10 10 10 10 10 10 10 10 10 10 10 10 10 10 10 10 10 10 10 10 10 11 
11  10 10 10 10 10 10 10 10 10 10 11 10 10 10 10 10 10 10 10 10 10 10 10 10 10 10 10 10 10 10 10 10 10 10 10 10 10 10 11
11  10 10 10 10 10 10 10 10 10 10 11 10 10 10 10 10 10 10 10 10 10 10 10 10 10 10 10 10 10 10 10 10 10 10 10 10 10 10 11 
11  10 10 10 10 10 10 10 10 10 10 11 10 10 10 10 10 10 10 10 10 10 10 10 10 10 10 10 10 10 10 10 10 10 10 10 10 10 10 11
11  10 10 10 10 10 10 10 10 10 10 11 10 10 10 10 10 10 10 10 10 10 10 10 10 10 10 10 10 10 10 10 10 10 10 10 10 10 10 11
11  10 10 10 10 10 10 10 10 10 10 11 10 10 10 10 10 10 10 10 10 10 10 10 10 10 10 10 10 10 10 10 10 10 10 10 10 10 10 11
11  10 10 10 10 10 10 10 10 10 10 11 10 10 10 10 10 10 10 10 10 10 10 10 10 10 10 10 10 10 10 10 10 10 10 10 10 10 10 11 
11  10 10 10 10 10 10 10 10 10 10 11 10 10 10 10 10 10 10 10 10 10 10 10 10 10 10 10 10 10 10 10 10 10 10 10 10 10 10 11 
11  10 10 10 10 10 10 10 10 10 10 11 10 10 10 10 10 10 10 10 10 10 10 10 10 10 10 10 10 10 10 10 10 10 10 10 10 10 10 11 
11  10 10 10 10 10 10 10 10 10 10 11 10 10 10 10 10 10 10 10 10 10 10 10 10 10 10 10 10 10 10 10 10 10 10 10 10 10 10 11
11  10 10 10 10 10 10 10 10 10 10 11 10 10 10 10 10 10 10 10 10 10 10 10 10 10 10 10 10 10 10 10 10 10 10 10 10 10 10 11 
11  10 10 10 10 10 10 10 10 10 10 11 10 10 10 10 10 10 10 10 10 10 10 10 10 10 10 10 10 10 10 10 10 10 10 10 10 10 10 11
11  11 11 11 11 11 11 11 11 11 11 11 11 11 11 11 11 11 11 11 11 11 11 11 11 11 11 11 11 11 11 11 11 11 11 11 11 11 11 11        